1,S,1,1,1,1,1,1,1,1,1,1,1,1,1,1,1,1,1,1,1,1,1,1,1,1,1,1,1,1,1,1
1,0,0,0,0,1,C,C,C,0,T,1,O,O,1,C,0,C,1,C,0,C,C,1,O,O,1,O,O,O,1,1
1,0,1,1,1,1,0,1,1,1,1,1,0,0,0,0,1,C,0,C,1,1,0,0,O,O,0,O,O,O,0,1
1,0,1,0,O,0,O,1,O,C,T,1,O,1,1,1,1,1,1,1,1,1,1,1,1,1,1,1,1,1,0,1
1,0,1,1,0,1,O,O,O,C,T,1,0,1,O,0,C,0,0,C,0,0,O,O,0,0,O,1,0,C,0,1
1,C,C,1,O,1,O,1,1,1,1,1,0,1,O,1,1,1,1,1,1,1,1,1,1,1,0,1,0,1,1,1
1,1,C,M,0,O,0,0,0,O,0,0,0,1,C,1,0,0,C,0,0,0,0,0,C,1,O,1,0,C,T,1
1,T,1,1,1,O,1,O,1,0,1,1,1,1,C,1,C,1,1,1,1,1,1,1,0,1,0,1,0,1,1,1
1,C,1,0,0,0,1,0,1,C,0,0,O,1,O,1,0,1,O,O,O,M,0,1,0,1,0,1,0,C,T,1
1,C,1,0,1,0,1,0,1,0,1,1,0,1,O,1,0,1,O,O,O,1,0,1,C,1,0,1,0,1,1,1
1,C,1,O,1,T,1,C,0,O,0,1,C,1,C,1,C,1,O,O,O,1,0,1,0,1,O,1,0,C,0,1
1,C,1,0,1,1,1,0,1,0,1,1,0,1,C,1,0,0,O,O,O,1,E,1,0,1,O,1,1,1,0,1
1,0,0,0,0,T,1,0,1,1,1,1,O,1,O,1,1,1,1,1,1,1,1,1,D,1,0,1,0,1,0,1
1,0,1,1,1,1,1,O,0,O,0,0,0,1,O,O,0,0,0,0,0,O,0,O,M,O,0,O,0,C,0,1
1,C,0,C,0,O,0,O,1,1,1,1,O,1,O,1,1,1,0,1,1,1,1,1,1,1,1,1,1,1,1,1
1,1,1,M,1,1,1,0,1,0,0,1,0,1,0,1,T,1,T,1,O,0,O,0,0,O,0,O,0,0,O,1
1,0,O,0,1,T,1,C,1,C,C,1,O,1,C,1,T,1,1,1,0,1,1,1,1,1,1,1,1,1,0,1
1,0,1,1,1,T,1,0,1,O,C,1,0,1,O,1,C,0,C,0,0,0,O,0,0,O,1,O,0,0,0,1
1,C,0,1,0,0,0,O,1,O,1,1,C,1,0,1,1,1,1,1,1,1,1,1,1,0,1,0,1,1,0,1
1,1,O,T,1,1,1,0,1,O,0,0,O,1,0,O,0,0,0,O,0,0,0,O,0,0,1,0,0,1,O,1
1,1,0,C,O,T,1,C,1,1,1,1,1,1,1,1,1,1,1,1,1,1,1,1,1,1,1,1,0,1,0,1
1,T,O,1,C,1,1,0,1,0,0,0,1,O,C,O,C,O,0,0,O,C,O,C,O,C,O,C,O,1,0,1
1,T,C,1,T,T,1,0,0,0,1,0,0,O,C,O,C,O,0,O,C,O,C,O,C,O,C,O,C,0,0,1
1,1,1,1,1,1,1,1,1,1,1,1,1,1,1,1,1,1,1,1,1,1,1,1,1,1,1,1,1,1,1,1