1,S,1,1,1,1,1,1,1,1,1,1,1,1,1,1,1,1,1,1,1,1,1,1,1,1,1,1,1,1,1,1
1,0,0,0,0,1,C,C,C,1,T,1,0,0,1,C,0,C,1,C,0,C,C,1,0,0,1,0,0,0,1,1
1,0,1,1,1,1,0,1,1,1,1,1,0,0,0,0,1,C,0,C,1,1,0,0,0,0,0,0,0,0,0,1
1,0,1,0,0,0,0,1,0,C,T,1,0,1,1,1,1,1,1,1,1,1,1,1,1,1,1,1,1,1,0,1
1,0,1,1,0,1,0,0,0,C,T,1,0,1,0,0,C,0,0,C,0,0,0,0,0,0,0,1,0,C,0,1
1,C,C,1,0,1,0,1,1,1,1,1,0,1,0,1,1,1,1,1,1,1,1,1,1,1,0,1,0,1,1,1
1,1,C,0,0,0,0,0,0,0,0,0,0,1,C,1,0,0,C,0,0,0,0,0,C,1,0,1,0,C,T,1
1,T,1,1,1,0,1,0,1,0,1,1,1,1,C,1,C,1,1,1,1,1,1,1,0,1,0,1,0,1,1,1
1,C,1,0,0,0,1,0,1,C,0,0,0,1,0,1,0,1,0,0,0,0,0,1,0,1,0,1,0,C,T,1
1,C,1,0,1,0,1,0,1,0,1,1,0,1,0,1,0,1,0,0,0,1,0,1,C,1,0,1,0,1,1,1
1,C,1,0,1,T,1,C,0,0,0,1,C,1,C,1,C,1,0,0,0,1,0,1,0,1,0,1,0,C,0,1
1,C,1,0,1,1,1,0,1,0,1,1,0,1,C,1,0,0,0,0,0,1,E,1,0,1,0,1,1,1,0,1
1,0,0,0,0,T,1,0,1,1,1,1,0,1,0,1,1,1,1,1,1,1,1,1,0,1,0,1,0,1,0,1
1,0,1,1,1,1,1,0,0,0,0,0,0,1,0,0,0,0,0,0,0,0,0,0,0,0,0,0,0,C,0,1
1,C,0,C,0,0,0,0,1,1,1,1,0,1,0,1,1,1,0,1,1,1,1,1,1,1,1,1,1,1,1,1
1,1,1,0,1,1,1,0,1,0,0,1,0,1,0,1,T,1,T,1,0,0,0,0,0,0,0,0,0,0,0,1
1,0,0,0,1,T,1,C,1,C,C,1,0,1,C,1,T,1,1,1,0,1,1,1,1,1,1,1,1,1,0,1
1,0,1,1,1,T,1,0,1,0,C,1,0,1,0,1,C,0,C,0,0,0,0,0,0,0,1,0,0,0,0,1
1,C,0,1,0,0,0,0,1,0,1,1,C,1,0,1,1,1,1,1,1,1,1,1,1,0,1,0,1,1,0,1
1,1,0,T,1,1,1,0,1,0,0,0,0,1,0,0,0,0,0,0,0,0,0,0,0,0,1,0,0,1,0,1
1,1,0,C,0,T,1,C,1,1,1,1,1,1,1,1,1,1,1,1,1,1,1,1,1,1,1,1,0,1,0,1
1,T,0,1,C,1,1,0,1,0,0,0,1,0,C,0,C,0,0,0,0,C,0,C,0,C,0,C,0,1,0,1
1,T,C,1,T,T,1,0,0,0,1,0,0,0,C,0,C,0,0,0,C,0,C,0,C,0,C,0,C,0,0,1
1,1,1,1,1,1,1,1,1,1,1,1,1,1,1,1,1,1,1,1,1,1,1,1,1,1,1,1,1,1,1,1